1 1 1 1 1 1 
1 0 0 0 0 1 
1 0 10 20 2 1 
1 0 2 10 0 1 
1 1 1 1 1 1 
5
4000